SEED: 1350808693
ллллллллллллллллллллл
л л   л             л
л л л ллл ллл ллл   л
л л л   л   л       л
л л л л л л л ллл   л
л     л   л л       л
ллллл ллллл ллл   ллл
л     л   л       л л
л л л л   л   ллл л л
л л л     л   л   л л
л л ллллл л   л ллл л
л   л         л     л
л ллл ллллллл ллл л л
л               л л л
л ллллллллллл л л л л
л   л   л   л л     л
ллл л л л л л л ллл л
л л   л   л л   л   л
л ллллл ллл л ллл ллл
л                   л
ллллллллллллллллллллл